BE	B IY
BEING	B IY IH NG
BUT	B AH T
DID	D IH D
FIRST	F ER S T
HAVE	HH AE V
IN	IH N
IS	IH Z
IT	IH T
MINION	M IH N Y AH N
NEED	N IY D
NOW	N AW
RIGHT	R AY T
SAY	S EY
SPUD	S P AH D
WHAT	W AH T
WHAT(2)	HH W AH T
WHICH	W IH CH
WHICH(2)	HH W IH CH
WITH	W IH DH
WITH(2)	W IH TH
WORK	W ER K
